destWidth 256
destHeight 1440
map_width 30
map_height 30
tile_width 32
tile_height 32
solid_tiles
33,34,35,185,186,187,194, 195, 201, 202, 203, 193
layer1
201, 202, 202, 202, 202, 202, 202, 202, 202, 202, 202, 202, 202, 202, 202, 202, 202, 202, 202, 202, 202, 202, 202, 202, 202, 202, 202, 202, 202, 203
0, 0, 0, 0, 0, 0, 0, 0, 0, 0, 0, 0, 0, 0, 0, 0, 0, 0, 0, 0, 0, 0, 0, 0, 0, 0, 0, 73, 75, 1
0, 0, 0, 0, 0, 0, 0, 0, 0, 0, 0, 0, 0, 0, 0, 0, 0, 0, 0, 0, 0, 0, 0, 0, 0, 0, 0, 81, 83, 1
1, 73, 74, 74, 74, 74, 74, 74, 74, 74, 74, 74, 74, 75, 3, 3, 3, 3, 73, 75, 0, 0, 0, 0, 0, 0, 0, 81, 83, 1
1, 81, 82, 82, 82, 82, 82, 82, 82, 82, 82, 82, 82, 83, 3, 0, 3, 3, 81, 83, 0, 0, 0, 0, 0, 0, 0, 81, 83, 1
1, 89, 90, 90, 90, 82, 82, 90, 90, 90, 90, 90, 82, 83, 3, 0, 3, 3, 81, 83, 0, 0, 0, 0, 0, 0, 0, 81, 83, 1
0, 0, 0, 0, 0, 81, 83, 0, 0, 0, 3, 3, 81, 82, 74, 74, 74, 74, 82, 83, 0, 0, 0, 0, 0, 0, 0, 81, 83, 0
0, 0, 0, 0, 0, 81, 83, 0, 0, 0, 0, 0, 81, 82, 82, 82, 82, 82, 82, 83, 0, 0, 0, 0, 0, 0, 0, 81, 83, 0
0, 0, 0, 0, 0, 81, 83, 0, 0, 0, 0, 0, 81, 82, 90, 90, 90, 90, 90, 91, 0, 0, 0, 0, 0, 0, 0, 81, 83, 0
0, 0, 0, 0, 0, 81, 83, 0, 0, 0, 0, 0, 81, 83, 0, 0, 0, 0, 0, 0, 0, 0, 0, 0, 0, 0, 0, 81, 83, 0
0, 0, 0, 0, 0, 81, 83, 0, 0, 73, 74, 74, 82, 83, 0, 0, 0, 0, 0, 0, 0, 0, 0, 0, 0, 0, 0, 81, 83, 0
0, 73, 74, 74, 74, 82, 83, 0, 0, 81, 82, 82, 82, 83, 0, 0, 0, 0, 0, 0, 0, 0, 0, 0, 0, 0, 0, 81, 83, 0
0, 81, 82, 82, 82, 82, 83, 0, 0, 89, 90, 90, 82, 83, 0, 0, 0, 0, 73, 75, 0, 0, 0, 0, 0, 0, 0, 81, 83, 0, 0
0, 81, 82, 90, 90, 90, 91, 0, 0, 0, 0, 0, 81, 83, 0, 0, 0, 0, 81, 83, 0, 0, 0, 0, 0, 0, 0, 81, 83, 0
0, 81, 83, 0, 0, 0, 0, 0, 0, 0, 0, 0, 81, 83, 0, 0, 0, 0, 81, 83, 0, 0, 0, 0, 0, 0, 0, 81, 83, 0
0, 81, 83, 0, 0, 0, 0, 73, 75, 0, 0, 0, 89, 91, 0, 0, 0, 0, 81, 83, 0, 0, 0, 0, 0, 0, 0, 81, 83, 0
0, 81, 83, 0, 0, 0, 0, 81, 83, 0, 0, 0, 0, 83, 0, 0, 0, 0, 81, 83, 0, 0, 0, 0, 0, 0, 0, 81, 83, 0
0, 81, 83, 0, 0, 0, 0, 73, 75, 0, 0, 0, 0, , 0, 0, 0, 0, 81, 83, 0, 0, 0, 0, 0, 0, 0, 81, 83, 0
0, 81, 83, 0, 0, 0, 0, 81, 83, 0, 0, 0, 0, 0, 0, 0, 0, 0, 81, 83, 0, 0, 0, 0, 0, 0, 0, 81, 83, 0
0, 81, 83, 0, 0, 0, 0, 81, 83, 0, 0, 0, 0, 0, 0, 0, 0, 0, 81, 83, 0, 0, 0, 0, 0, 0, 0, 81, 83, 0
0, 81, 82, 74, 74, 74, 74, 82, 82, 74, 74, 74, 74, 74, 74, 74, 74, 74, 82, 83, 0, 0, 0, 0, 0, 0, 0, 81, 83, 0
0, 81, 82, 82, 82, 82, 82, 82, 82, 82, 82, 82, 82, 82, 82, 82, 82, 82, 82, 83, 0, 0, 0, 0, 0, 0, 0, 81, 83, 0
0, 81, 82, 90, 90, 90, 90, 90, 90, 90, 90, 90, 90, 90, 90, 90, 90, 90, 82, 83, 0, 0, 0, 0, 0, 0, 0, 81, 83, 0
0, 81, 83, 0, 0, 0, 0, 0, 0, 0, 0, 0, 0, 0, 0, 0, 0, 0, 81, 83, 0, 0, 0, 0, 0, 0, 0, 81, 83, 0
0, 81, 83, 0, 0, 0, 0, 0, 0, 0, 0, 0, 0, 0, 0, 0, 0, 0, 81, 83, 0, 0, 0, 0, 0, 0, 0, 81, 83, 0
0, 81, 83, 0, 0, 0, 0, 0, 0, 0, 0, 0, 0, 0, 0, 0, 0, 0, 81, 83, 0, 0, 0, 0, 0, 0, 0, 81, 83, 0
0, 81, 83, 0, 0, 0, 0, 0, 0, 0, 0, 0, 0, 0, 0, 0, 0, 0, 81, 83, 0, 0, 0, 0, 0, 0, 0, 81, 83, 0
0, 81, 82, 74, 74, 74, 74, 74, 74, 75, 0, 0, 0, 73, 74, 74, 74, 74, 82, 82, 74, 74, 74, 74, 74, 74, 74, 82, 83, 0
0, 81, 82, 82, 82, 82, 82, 82, 82, 83, 0, 0, 0, 81, 82, 82, 82, 82, 82, 82, 82, 82, 82, 82, 82, 82, 82, 82, 83, 0
0, 0, 0, 0, 0, 0, 0, 0, 0, 0, 0, 0, 0, 0, 0, 0, 0, 0, 0, 0, 0, 0, 0, 0, 0, 0, 0, 0, 0, 0

layer2
0, 0, 0, 0, 0, 0, 0, 0, 0, 0, 0, 0, 0, 0, 193, 194, 194, 195, 0, 0, 193, 194, 194, 194, 194, 194, 195, 0, 0, 0
33, 34, 34, 34, 34, 34, 34, 34, 34, 34, 34, 34, 34, 34, 193, 194, 194, 195, 34, 34, 193, 194, 194, 194, 194, 194, 195, 34, 34, 35
33, 34, 34, 34, 34, 34, 34, 34, 34, 34, 34, 34, 34, 34, 193, 194, 194, 195, 34, 34, 193, 194, 194, 194, 194, 194, 195, 34, 34, 35
0, 0, 0, 0, 0, 0, 0, 0, 0, 0, 0, 0, 0, 0, 201, 202, 202, 203, 0, 0, 193, 194, 194, 194, 194, 194, 195, 0, 0, 0
0, 0, 0, 0, 0, 0, 0, 0, 0, 0, 0, 0, 0, 0, 33, 34, 34, 35, 0, 0, 193, 194, 194, 194, 194, 194, 195, 0, 0, 0
186, 186, 186, 186, 187, 3, 3, 185, 186, 186, 186, 187, 3, 3, 33, 34, 34, 35, 3, 0, 193, 194, 194, 194, 194, 194, 195, 0, 0, 185
194, 194, 194, 194, 195, 3, 3, 193, 194, 194, 194, 195, 3, 3, 3, 0, 3, 3, 3, 0, 193, 194, 194, 194, 194, 194, 195, 0, 0, 193
194, 194, 194, 194, 195, 3, 0, 193, 202, 202, 202, 203, 0, 3, 3, 0, 3, 3, 0, 0, 193, 194, 194, 194, 194, 194, 195, 0, 0, 193
202, 202, 202, 202, 203, 3, 3, 193, 195, 34, 34, 35, 0, 3, 185, 186, 186, 186, 186, 186, 193, 194, 194, 194, 194, 194, 195, 0, 0, 193
195, 34, 34, 34, 35, 3, 3, 193, 195, 34, 34, 35, 0, 3, 193, 194, 194, 202, 202, 202, 193, 194, 194, 194, 194, 194, 195, 0, 0, 193
195, 34, 34, 34, 35, 3, 3, 193, 195, 0, 0, 0, 0, 3, 193, 194, 194, 195, 33, 35, 193, 194, 194, 194, 194, 194, 195, 0, 0, 193
195, 3, 3, 3, 3, 3, 3, 193, 195, 3, 3, 3, 0, 3, 193, 194, 194, 195, 33, 35, 193, 194, 194, 194, 194, 194, 195, 0, 0, 193
195, 3, 3, 3, 3, 3, 3, 193, 186, 186, 186, 187, 0, 3, 193, 194, 194, 195, 0, 0, 193, 194, 194, 194, 194, 194, 195, 0, 0, 193
195, 3, 3, 185, 186, 186, 186, 186, 194, 194, 194, 195, 3, 3, 193, 194, 194, 195, 0, 0, 193, 194, 194, 194, 194, 194, 195, 0, 0, 193
195, 3, 3, 193, 194, 194, 195, 202, 202, 193, 194, 195, 3, 3, 193, 194, 194, 195, 3, 3, 193, 194, 194, 194, 194, 194, 195, 3, 3, 193
195, 3, 3, 193, 194, 194, 195, 33, 35, 193, 194, 195, 3, 3, 193, 194, 194, 195, 3, 3, 193, 194, 194, 194, 194, 194, 195, 3, 3, 193
195, 3, 3, 193, 194, 194, 195, 33, 35, 193, 194, 186, 186, 186, 186, 194, 194, 195, 3, 3, 193, 194, 194, 194, 194, 194, 195, 0, 3, 193
195, 3, 3, 201, 202, 202, 203, 3, 3, 201, 202, 202, 202, 202, 202, 202, 202, 203, 3, 0, 193, 194, 194, 194, 194, 194, 195, 3, 3, 193
195, 3, 3, 33, 34, 34, 35, 3, 3, 33, 34, 34, 34, 34, 34, 34, 34, 35, 3, 3, 193, 194, 194, 194, 194, 194, 195, 3, 3, 193
195, 0, 0, 33, 34, 34, 35, 0, 0, 33, 34, 34, 34, 34, 34, 34, 34, 35, 3, 3, 193, 194, 194, 194, 194, 194, 195, 0, 0, 193
195, 0, 0, 0, 0, 0, 0, 3, 3, 0, 3, 3, 0, 3, 3, 3, 3, 3, 3, 0, 193, 194, 194, 194, 194, 194, 195, 0, 0, 193
195, 0, 0, 3, 3, 3, 3, 0, 0, 3, 3, 0, 3, 3, 0, 3, 3, 3, 3, 0, 193, 194, 194, 194, 194, 194, 195, 0, 0, 193
195, 3, 3, 185, 186, 186, 186, 186, 186, 186, 186, 186, 186, 186, 186, 186, 186, 187, 0, 0, 193, 194, 194, 194, 194, 194, 195, 0, 0, 193
195, 0, 3, 193, 194, 194, 194, 194, 194, 194, 194, 194, 194, 194, 194, 194, 194, 195, 0, 0, 193, 194, 194, 194, 194, 194, 195, 0, 0, 193
195, 3, 0, 201, 202, 202, 202, 202, 202, 202, 193, 194, 195, 202, 202, 202, 202, 203, 0, 0, 201, 202, 202, 202, 202, 202, 203, 0, 0, 193
195, 3, 3, 33, 34, 34, 34, 34, 34, 34, 193, 194, 195, 33, 34, 34, 34, 35, 0, 0, 33, 34, 34, 34, 34, 34, 35, 3, 3, 193
195, 3, 3, 33, 34, 34, 34, 34, 34, 34, 193, 194, 195, 33, 34, 34, 34, 35, 0, 0, 33, 34, 34, 34, 34, 34, 35, 3, 3, 193
195, 0, 0, 3, 3, 3, 3, 0, 3, 3, 193, 194, 195, 3, 3, 3, 3, 3, 3, 3, 0, 0, 0, 0, 3, 3, 0, 0, 0, 193
195, 0, 0, 0, 3, 3, 3, 3, 0, 3, 193, 194, 195, 3, 3, 3, 3, 3, 3, 3, 3, 3, 0, 0, 0, 0, 0, 0, 0, 193
186, 186, 186, 186, 186, 186, 186, 186, 186, 186, 186, 186, 186, 186, 186, 186, 186, 186, 186, 186, 186, 186, 186, 186, 186, 186, 186, 186, 186, 193
